#####################
E                  1#
# # #####U# ##### # #
# # #     #   #   # #
####### # #######P# #
#       #   #   # # #
# ###P##### # # # # #
# #   #   # # #   # #
# ### # ####### #####
# #   # #   #   # # #
# # ### # # ### # # #
# #     # # #       #
### ##### ### # ### #
#     #     # #   # #
# ### # ### ##### ###
#   #   #       # # #
# ####### ####### # #
# #     # #  P  #   #
# ### ### ##### ### #
# #             #   F
#####################
